....................
.P-------w---------.
.--------w---------.
.--------w---------.
.----wwwww---------.
.------------------.
.------------------.
.------------------.
.------------------.
.------------------.
.------------------.
.-----------e------.
.------------------.
.------------------.
.------------------.
.------------------.
.------------------.
.------------------.
.------------------.
....................